AAGCTCCTAGTTGCGC	CTTTCCGTCC
AAGCTCCTCAGATCTT	CCTATAACGT
AAGCTCCTCTGTTACA	CCGACTGAAA
AAGCTCCTTCATGACA	TATCGCGAGT
AATCGTCTAGTTGCGC	ATACCGTTCT
AATCGTCTCAGATCTT	AGGTTCCTGC
AATCGTCTCTGTTACA	TCTAAGTGGC
AATCGTCTTCATGACA	GTACTATGGC
ACGCCAAGAGTTGCGC	TGAGTACGAC
ACGCCAAGCAGATCTT	TGCATCACGT
ACGCCAAGCTGTTACA	ACGTTTAAGC
ACGCCAAGTCATGACA	CAGTAAAGGT
ACTGGGTTAGTTGCGC	TACTAGGACT
ACTGGGTTCAGATCTT	AAACGCTCAC
ACTGGGTTCTGTTACA	GCAACTTGGC
ACTGGGTTTCATGACA	CCTACTCCCT
AGCCCTACAGTTGCGC	TTGACGGTTT
AGCCCTACCAGATCTT	CGGATACAAT
AGCCCTACCTGTTACA	CATGACACCC
AGCCCTACTCATGACA	CGAATAGTCT
ATACTGAGAGTTGCGC	GGTGTAGCGT
ATACTGAGCAGATCTT	TGATGTCGCG
ATACTGAGCTGTTACA	CAATACTGCG
ATACTGAGTCATGACA	TCTCAATGAC
ATCATCCTAGTTGCGC	GACTACATTC
ATCATCCTCAGATCTT	CGTAAGACCG
ATCATCCTCTGTTACA	GGTCACTAGG
ATCATCCTTCATGACA	GCGCTTTGTC
CCCTCAAAAGTTGCGC	CCCACACCAT
CCCTCAAACAGATCTT	CTTCGGCGTA
CCCTCAAACTGTTACA	AGTCTCAGAC
CCCTCAAATCATGACA	ACATCCGATG
CCTCAGGAAGTTGCGC	CTTTGGATGA
CCTCAGGACAGATCTT	TGGTCATCCA
CCTCAGGACTGTTACA	AAAGGGAACT
CCTCAGGATCATGACA	CAACGTGCCT
GAGAGTGCAGTTGCGC	ATGCAGCAAA
GAGAGTGCCAGATCTT	CGTTGCCTAC
GAGAGTGCCTGTTACA	GACGTCAGCA
GAGAGTGCTCATGACA	GGACAGTTAA
GAGTCATGAGTTGCGC	CCATTGTAGT
GAGTCATGCAGATCTT	TAGTGTGATG
GAGTCATGCTGTTACA	CCCATCGGAT
GAGTCATGTCATGACA	CTGTTGACGA
GCACAGCTAGTTGCGC	GGTACTCACG
GCACAGCTCAGATCTT	CCATTACGCT
GCACAGCTCTGTTACA	ACCCAATAAC
GCACAGCTTCATGACA	GGCTAGTCAA
GCCATTATAGTTGCGC	CAAGTCCGGT
GCCATTATCAGATCTT	CAACCTTCTG
GCCATTATCTGTTACA	ACTCCTTGAT
GCCATTATTCATGACA	CAAGTGCAAC
GCGCTTACAGTTGCGC	ACCAGCATAT
GCGCTTACCAGATCTT	AAATCGGCGT
GCGCTTACCTGTTACA	CGTGGTTGTG
GCGCTTACTCATGACA	TGCAGTATGT
GTAAACAGAGTTGCGC	ATCTCCAGAT
GTAAACAGCAGATCTT	AGGTCTCGCT
GTAAACAGCTGTTACA	AGCTGCCATG
GTAAACAGTCATGACA	GGACATATGA
GTGGGACAAGTTGCGC	GCACTCTGGA
GTGGGACACAGATCTT	AGGTGTAGGA
GTGGGACACTGTTACA	CGGATGTGCT
GTGGGACATCATGACA	GCGACATGAC
GTTCCAAAAGTTGCGC	TGTTGTGGGC
GTTCCAAACAGATCTT	GTTTCGTCAC
GTTCCAAACTGTTACA	CCACGGTGAA
GTTCCAAATCATGACA	GCCATGAGAC
TAAGTCACAGTTGCGC	GTAATTGCAG
TAAGTCACCAGATCTT	CTTCAACGCG
TAAGTCACCTGTTACA	GTAACCTCTA
TAAGTCACTCATGACA	AAGTATCTCC
TAGCTAAGAGTTGCGC	CGGGTTAAAT
TAGCTAAGCAGATCTT	ACGTTAGCTG
TAGCTAAGCTGTTACA	TTTCGCGTTG
TAGCTAAGTCATGACA	TACAGGATTC
TCTTGAACAGTTGCGC	CTTTGACAAG
TCTTGAACCAGATCTT	ATAGCTTGGA
TCTTGAACCTGTTACA	TTTCGTAGGA
TCTTGAACTCATGACA	GGAAGGAACT
TGGAACTAAGTTGCGC	AAGACTGGTT
TGGAACTACAGATCTT	TGATAACCAC
TGGAACTACTGTTACA	ACGCTTTCAC
TGGAACTATCATGACA	TGCACTTCAT
TGGTATTCAGTTGCGC	GCATGTATCT
TGGTATTCCAGATCTT	ATCCACGGAG
TGGTATTCCTGTTACA	TCATCTGATC
TGGTATTCTCATGACA	GCTGATTGTT
TGTCGGCTAGTTGCGC	CACTATCCGC
TGTCGGCTCAGATCTT	AGTGACTCCT
TGTCGGCTCTGTTACA	TTGGTGGCGT
TGTCGGCTTCATGACA	CTCCTGTCGA
TTGGACTCAGTTGCGC	ACACCTAGAG
TTGGACTCCAGATCTT	CCAAAGATCT
TTGGACTCCTGTTACA	CGAGTGAATA
TTGGACTCTCATGACA	CCGTGAATCC
