AAGCTCCTAGTTGCGC	TTCCCTGAACCTCGT
AAGCTCCTCAGATCTT	CTCCTGTACATATAT
AAGCTCCTCTGTTACA	ACGTTTCACTATAAT
AAGCTCCTTCATGACA	ATGACCGACCACTTT
AATCGTCTAGTTGCGC	TACTACTATTATAAT
AATCGTCTCAGATCTT	TCCTCATGTGCGTAT
AATCGTCTCTGTTACA	CCTAGGACAATTTAT
AATCGTCTTCATGACA	TACTTATACCCGTAT
ACGCCAAGAGTTGCGC	CTCTGACATATTATT
ACGCCAAGCAGATCTT	AAAGAAGATACTTAA
ACGCCAAGCTGTTACA	CTACACGGATCTGAA
ACGCCAAGTCATGACA	ATTATAATTCGGAAA
ACTGGGTTAGTTGCGC	CCGGAAACTCGTTAT
ACTGGGTTCAGATCTT	CTTGTTAGTCTTCTA
ACTGGGTTCTGTTACA	CTTATGCATATCACT
ACTGGGTTTCATGACA	ACTTTCTTGTCACTC
AGCCCTACAGTTGCGC	TAGTGTCATCTTTGC
AGCCCTACCAGATCTT	GTCCGTCGATATGTA
AGCCCTACCTGTTACA	GAGGTTTACCGTCTA
AGCCCTACTCATGACA	ATTTATCTCGAGTAT
ATACTGAGAGTTGCGC	TGACCATCACGAGTA
ATACTGAGCAGATCTT	ACGTGCAATTAAATA
ATACTGAGCTGTTACA	CTTTACCTTGATGAC
ATACTGAGTCATGACA	TTATGAATCCCGAGT
ATCATCCTAGTTGCGC	AAGATACATCATACC
ATCATCCTCAGATCTT	ATCCTACTTGATCTA
ATCATCCTCTGTTACA	CCGTGTAGTTTAGGT
ATCATCCTTCATGACA	GTATGCTGCAAGATT
CCCTCAAAAGTTGCGC	GTGGGTGAGGTTGCT
CCCTCAAACAGATCTT	CAAAGGTAGAGAGTT
CCCTCAAACTGTTACA	CACAGATATCCCTCC
CCCTCAAATCATGACA	AAGAGTCTAGGATAT
CCTCAGGAAGTTGCGC	ATATTTATCCTGACC
CCTCAGGACAGATCTT	GTACGTCGATACCCT
CCTCAGGACTGTTACA	TCCCGAAGCAGTATT
CCTCAGGATCATGACA	TCCCACCATAACTTA
GAGAGTGCAGTTGCGC	GGAATCCTACGTTTC
GAGAGTGCCAGATCTT	ATATAAAGTGTGCGT
GAGAGTGCCTGTTACA	TTAGTGGTATTTAGT
GAGAGTGCTCATGACA	GTTCGTTGAGGCTCT
GAGTCATGAGTTGCGC	CAACCCGTTGCTAGT
GAGTCATGCAGATCTT	CCCTGGGCCCGAGGT
GAGTCATGCTGTTACA	TCAATCCCTGTGACC
GAGTCATGTCATGACA	TCACCATATACACTA
GCACAGCTAGTTGCGC	TGTCGATAGTTAGTT
GCACAGCTCAGATCTT	ATGTACTATATGATC
GCACAGCTCTGTTACA	GTTAGTTATCCTCCT
GCACAGCTTCATGACA	CCGGAGTACCTAGAT
GCCATTATAGTTGCGC	ATTTAAGGTGCACGA
GCCATTATCAGATCTT	CAAGATACTGTGTTC
GCCATTATCTGTTACA	ACAGTCTTTAACTCC
GCCATTATTCATGACA	TGGGCTATACGTATC
GCGCTTACAGTTGCGC	CCCAGTGAGTCCCAT
GCGCTTACCAGATCTT	CCGAGTTGCAGATTC
GCGCTTACCTGTTACA	AAGTTAGGACAAGGT
GCGCTTACTCATGACA	ACCCACATCGTACCC
GTAAACAGAGTTGCGC	AAAGTATGATATGTC
GTAAACAGCAGATCTT	GTGTAGTAGGGCTAT
GTAAACAGCTGTTACA	ATCTATCACGTTTCC
GTAAACAGTCATGACA	TGATGCTACCGTGAC
GTGGGACAAGTTGCGC	CTAATATACGTATGT
GTGGGACACAGATCTT	CATCCTCGTTTCATT
GTGGGACACTGTTACA	GTCGCCCTTGAGGTT
GTGGGACATCATGACA	ACCTCTGCACACACT
GTTCCAAAAGTTGCGC	TCTACACTCTTCGGT
GTTCCAAACAGATCTT	CCCGAAGGCCTGTTC
GTTCCAAACTGTTACA	GGGTGTCACTTGCGT
GTTCCAAATCATGACA	ATGACACTACCTCTC
TAAGTCACAGTTGCGC	AATCTTCTTACGGTT
TAAGTCACCAGATCTT	CTCGTAGGATCTCGT
TAAGTCACCTGTTACA	TTATAATGAGTGCGC
TAAGTCACTCATGACA	GTGAGGATCCTGTTA
TAGCTAAGAGTTGCGC	GGATATTAAGCAATC
TAGCTAAGCAGATCTT	CTTCTTTCCGTCTGA
TAGCTAAGCTGTTACA	ATCGTTATATCATAA
TAGCTAAGTCATGACA	TAACTAGTTGAAGAT
TCTTGAACAGTTGCGC	CCCTACCCGAACACT
TCTTGAACCAGATCTT	CTATGGTATCCTATA
TCTTGAACCTGTTACA	ACCCGTATCGTCTTA
TCTTGAACTCATGACA	TCACTTGACATATTT
TGGAACTAAGTTGCGC	TCTCTTGGTAAGGGT
TGGAACTACAGATCTT	TATCATACACGTCTT
TGGAACTACTGTTACA	ATATCGGTATGTCCT
TGGAACTATCATGACA	CTATTATCAATATTT
TGGTATTCAGTTGCGC	TGACGTCGTAGATCT
TGGTATTCCAGATCTT	GAAGGCTTCACACGT
TGGTATTCCTGTTACA	AATTCCGTATTATTC
TGGTATTCTCATGACA	CAGTCCTGTATGATC
TGTCGGCTAGTTGCGC	ATTTATCGTAGTCTA
TGTCGGCTCAGATCTT	TGACACAAGAGCTCT
TGTCGGCTCTGTTACA	ATGCAACTCGATCGA
TGTCGGCTTCATGACA	CAGTACTACTCGAGT
TTGGACTCAGTTGCGC	TACTACGTGCGTACT
TTGGACTCCAGATCTT	TGTACGGCACTACAC
TTGGACTCCTGTTACA	ACACCCATATCGAAC
TTGGACTCTCATGACA	CCGGGTTTACCTCCT
